###########
####     ##
#### $#  ##
###     ###
#.      .##
#  #  # @##
###  #  ###
# $      ##
#  #  #  ##
###########
###########
