###########
####     ##
####  #  ##
###  #  ###
#     $  ##
#  #  #$ ##
###  #  ###
#.   @.  ##
#  #  #  ##
###########
###########
