###########
###########
##        #
##    @   #
###  # ## #
#  $    . #
#         #
### #  ## #
# $       #
#  .      #
###########
