########
########
#      #
#      #
### ## #
#. $ $ #
#@ .   #
########
