########
########
#@ .   #
# $    #
##  ####
##  ####
##  ####
########
