########
### ##.#
#      #
#  $   #
###  $ #
#   #  #
#.@ ####
########
