###########
###########
###########
###########
###########
#         #
#         #
## ## ## ##
#         #
#  @      #
###########
