###########
#   #    ##
#@#  # # ##
##  .  $ ##
##  . $  ##
## #   # ##
## # # ####
##     ####
##@# ######
##  #######
###########
