###########
###########
#         #
#  $     .#
###  # ## #
#        .#
#    $  $ #
### #   # #
###.    @ #
###########
###########
