########
##### ##
#     ##
#   $ @#
#  .   #
########
########
########
