###########
###########
# .     . #
#   .     #
### ## ## #
#         #
#   $ $ $ #
###@ .##
#   $ ##
#       #
###########
