###########
###########
###########
###########
###########
#         #
#   @     #
###########
###########
###########
###########
