###########
# .#  #  ##
#         #
#  #  #   #
#  #  # $.#
# . $    ##
#      $###
# $   .  ##
# @#  #  ##
###########
###########
