###########
###########
#     @   #
#  .  .   #
### ## ## #
#  .      #
#   $ $   #
###  $ ####
###    ####
###########
###########
