###########
# . #######
#    @  .##
# ##     ##
#   #######
# $   #####
# # $ #####
#     #  ##
#  #     ##
####  #  ##
###########
