########
########
#   .  #
#  $ $ #
###   .#
#   #  #
#@  #  #
########
