###########
#### # ####
#.   # ####
# ##     ##
#    .  $ #
##        #
#  $ # ####
#      #  #
###  $# # #
###    . @#
###########
