###########
###  #@####
### .  .###
##   $   ##
#  $  . $ #
##  .$#  .#
#     ..  #
#   $   $ #
# $  #   ##
##    #####
###########
