###########
#######  ##
#     .$  #
#         #
#  $   $. #
#@ #  #  ##
###  #  ###
# .      ##
#  #  #  ##
###########
###########
