###############
#######  ### ##
#            ##
#   $  $ .    #
### #   # #.  #
#        .  $ #
#    .     $ .#
##    #### #  #
## $ .###     #
# #    #### # #
# #  $  #    ##
#   #   #@#####
#####     #####
###############
###############
