###########
####     ##
####  #  ##
###  #  ###
#        ##
#  #  #  ##
###  #  ###
#@       ##
#  #  #  ##
###########
###########
