########
####  ##
#   $  #
#      #
#  .   #
#  #@ ##
########
########
