###########
#  #  #  ##
#@   .   ##
#  #  #  ##
#  #  #  ##
#.$  $..  #
#  $.. $$ #
# $.$$ .  #
#  #  #  ##
###########
###########
