###############
#    .  .    ##
#       .    ##
## ## ## ## ###
#       .    ##
#          $ ##
## ## ## ##   #
#       .     #
# $       $ ###
##  $ .  $ # @#
#       $     #
#  #  #  #  ###
###############
###############
###############
