###########
###########
#  .  .  @#
#         #
### ## ## #
#         #
#  $ $    #
###   #####
#  $  #####
#   .  ####
###########
