###########
#####  ####
#     $   #
# @  $    #
### #  #  #
#  .    $ #
#     .  .#
### ## ## #
###       #
###########
###########
