###########
###########
###########
#######   #
#     . #@#
# #  #   ##
##       ##
#    ## $ #
# $# ##   #
#    ##  .#
###########
