########
#  #  ##
#@  $  #
#.     #
# $ .  #
#  #  ##
########
########
