###############
#####   ##   ##
##### # #  # ##
# # #  ## $   #
# #      .  # #
#   # #$  .   #
###      $ # ##
###### ##    ##
######    #####
##  .  $ .#####
#     #  .#   #
##$ .  .  $ $ #
#   ##### @ # #
###########   #
###############
