###########
# #.#  ####
# $ $    ##
#    .  @##
# # $#.$###
# $      .#
#  . $. $##
#..  .    #
# $# $ $ ##
#.       ##
###########
