###########
#   #   ###
# #  ## ###
#  $    .##
##  .##$ ##
#####    ##
###### # ##
#   #   .##
###@#  $ ##
#   ##  ###
###########
