########
########
#  .   #
#   $  #
###@   #
#   #  #
#   ####
########
