##################
#  #  #  #  #  ###
#   ..          ##
#  #  #  #  #  ###
# @#  #  #  #  ###
#         ..    ##
#  #  #  #  #  ###
#  #  #  #  #  ###
#.  .   .  $    ##
#  #  #  #   $ ###
#  #  #  ## $ ####
#. . $  $  $   ###
#   $ $   $    ###
# #  #  #  #  ####
#  #  #  #  #  ###
#  #  #  #  #  ###
##################
##################
