###########
###########
#      .  #
#     .@$ #
### ## $  #
#     $   #
#  .    ###
######  ###
###########
###########
###########
