###########
#######  ##
#      $  #
#    .  @ #
#   $     #
#  #  #  ##
###  #  ###
#   .    ##
#  #  #  ##
###########
###########
