###########
###########
#  .  .  .#
# $  $ $  #
#@#.#   # #
#.   .$.  #
# $ $.    #
##  # $ #.#
# $ $   $ #
#   .     #
###########
