###########
######  ###
##       ##
##   $ # ##
##     # ##
##. $ .  ##
## $ $  @##
##  .  $ ##
##  ..   ##
###########
###########
