########
########
#@#  # #
#  $$  #
#     .#
# # .# #
########
########
