########
###    #
#   .  #
#  $ ###
### @###
########
########
########
