###########
###########
#   .. .  #
#@  . $ $ #
#  # $ $  #
# $ . #  ##
#   .#  ###
# $      ##
#  #  #  ##
###########
###########
