###############
####  # # #####
#    @$ $ .  ##
### $      ####
## .  #  #   ##
##   .. $    ##
##  $# $ $ #  #
###  .  $ . # #
### # #       #
####   #.  ####
####   # # ####
#  # #  . #####
# # #  # ######
#   ##   ######
###############
