########
###@ ###
##  $ ##
## .  ##
### ####
##    ##
########
########
