###########
#######  ##
#     .   #
#    $  $ #
#   .     #
#  #  #  ##
###  # @###
#        ##
#  #  #  ##
###########
###########
