########
#  #####
#    ###
#. @ ###
# $   ##
#  #  ##
########
########
