########
####  ##
#    @##
#  $ .##
# $   ##
#  .  ##
########
########
