###############
#  #  #  #  ###
# $ .   $  .  #
#.     $  $ $ #
#  ..   $  $  #
#  #  #  #  ###
###  #  #  #  #
#   .  .  @   #
#  #  #  #  ###
###  #  #  #  #
#             #
#  #  #  #  ###
###############
###############
###############
