###########
####@ #####
#### #    #
### .  $  #
### # .  ##
###   #   #
#    .  # #
###  $# $ #
#  $  .   #
##   ######
###########
