###############
###############
#       .    ##
#            ##
## ## ## ## ###
# .          ##
#   . $ $  .  #
#  # $    $   #
# $ . #  #  ###
#    #  #  #  #
# $@   .      #
#  #  #  #  ###
###############
###############
###############
