###########
###########
#   .     #
#   $@$.  #
#### .# ###
#   $ # ###
#     #####
# ## ######
#       ###
###########
###########
