###########
###########
#         #
#.@ $     #
####   #
#  .   #
#  $####
##
##
##
###########
