##################
######   ####   ##
#    # # #### # ##
##$ ##  ##   .   #
#  .   ##### . $##
#### $    .   .  #
####    ##    . ##
#### #     $    ##
#####  $###  # # #
####     ###     #
###### #### # ####
##             ###
#### # #  ####  ##
##### .  $ . .   #
### @       $ $  #
### #  #  #  $  ##
####     #    ####
##################
