##################
####  ### # #   ##
##  # ### # # # ##
#  .  #     ##  ##
# $ ###   # ######
##  #### $    ####
#  $    . .. .  ##
#        $  $   ##
########   .  ####
######## $  ##   #
#    ####    # ###
# #$ ##### $  .  #
#   . ..  #  #####
###@#   #      ###
###    $ # ### # #
#### #$    ### # #
####    ######   #
##################
