###########
###  ######
###  ######
###  ######
###  ######
###  ######
###  ######
###  ######
###  ######
###@ ######
###########
