###########
##  . .  ##
##   $ $ ##
##  $   ###
# $   $  ##
#  $ .   ##
### ..   ##
#  ..  $ ##
#@ #  #  ##
###########
###########
