###########
###########
#   . .   #
#        .#
### ##  $ #
#      #  #
# $ @$ #  #
##
##
##
###########
