########
########
#   .  #
#    $@#
# $ . ##
##    ##
###   ##
########
