###############
#  #  #     ###
#       $    ##
##  #  #  #  ##
#  #  #  #  ###
#            ##
##  # $   #  ##
#  #  #$ #  ###
#  $ .  ..   ##
##$    #  #  ##
#  .  . .  .###
# $  . $  $  ##
##  # @#  #  ##
###############
###############
