##################
##   #############
## #####   ##    #
##   ### #  ###$ #
##  $   #  #     #
#  $  ##  .  ## ##
# #  .  # ###  .##
#  ####   ### # ##
###   ####    # ##
### $# ### # #####
# #    ##  @#   ##
# #  # #  $  $ $ #
#  ..# ##   .    #
# # .  #  .  $####
# #  # ####    ###
#  . $ #####  ####
###    ###########
##################
