###########
###########
#         #
#    $    #
## ##  #$ #
#  .  .  .#
#  @   $  #
## ##  # ##
##       ##
###########
###########
