########
####  ##
##    ##
## $ .##
#   $  #
# @.   #
########
########
