###########
##  #  #  #
## $   $  #
##   $    #
##   #  ###
#     #  ##
#.$  . @ ##
# #  #  ###
#  #..#  ##
#  #  #  ##
###########
