###########
#  #  #  ##
#       $ #
# .#  #  .#
#  #  #   #
#@ $ $.  ##
#       ###
#  $    .##
#  #  #  ##
###########
###########
