########
#####  #
#   .  #
#  #  ##
##  $@##
##     #
#####  #
########
