########
########
########
########
########
#      #
#  @   #
########
